WWWWWWWWWWWWWWWWWWWW
WWIIIIBIITIIIBIIIIWW
WWILIIILZZZZLIIIIIWW
WWIIIIIIIILIIIIIIIWW
WWIIILIIIIIIIILIIIWW
WWBIIIIIIIIIIIIIIBWW
WWIIILIIIIIIIILIIIWW
WWIIIIIIIIIIIIIIIIWW
WWIIILIIIIIIIILIIIWW
WWBIIIIIIIIIIIIIIBWW
WWIIILIIIIIIIILIIIWW
WWIIIIIIILILIIIIIIWW
WWIIILIIIIIIIILIIIWW
WWBIIIIIIIIIIIIIIBWW
WWIIILIIIIIIIILIIIWW
WWLIIIIIIIIIILIIIIWW
WWVIILIIIIIIIILIIIWW
WWBIIIIIIIIIIVILIBWW
WWIIILIIIIIIIILIIIWW
WWLIIIIIIIIIIIIIIIWW
WWIIIIIIIIIIIIIIIIWW
WWWWWWWWWGGWWWWWWWWW
