WWWWWWWWWWWWWWWWWWWW
WWIIIIBIITIIIBIIIIWW
WWIIIIIIZZZZIIIIIIWW
WWIIIIIIIIIIIIIIIIWW
WWIIILIIIIIIIILIIIWW
WWBIIIIIIIIIIIIIIBWW
WWIIILIIIIIIIILIIIWW
WWIIIIIIIIIIIIIIIIWW
WWIIILIIIIIIIILIIIWW
WWBIIIIIIIIIIIIIIBWW
WWIIILIIIIIIIILIIIWW
WWIIIIIIIIIIIIIIIIWW
WWIIILIIIIIIIILIIIWW
WWBIIIIIIIIIIIIIIBWW
WWIIILIIIIIIIILIIIWW
WWIIIIIIIIIIIIIIIIWW
WWIIILIIIIIIIILIIIWW
WWBIIIIIIIIIIIIIIBWW
WWIIILIIIIIIIILIIIWW
WWIIIIIIIIIIIIIIIIWW
WWIIIIIIIIIIIIIIIIWW
WWWWWWWWWGGWWWWWWWWW
