WWWWWWWWWWWWWWWWWW
WWWWWWPPTPPWWWWWWW
WWWWPPPPPPPPWWWWWW
WWWPPLPPPPPLPPWWWW
WWWPPPPPPPPPPPWWWW
WWWWWGPPPPGWWWWWWW
WWWPPPPPPPPPPPWWWW
WWWPLPPPPPPLPPWWWW
WWWPPPPPPPPPPPWWWW
WWWWWGPPPPGWWWWWWW
WWWPPPPPPPPPPPWWWW
WWWPLPPPPPPPLPWWWW
WWWPPPPPPPPPPPWWWW
WWWWWGPPPPGWWWWWWW
WWWPPPPPPPPPPPWWWW
WWWPLPPPPPPPLPWWWW
WWWPPPPPPPPPPPWWWW
WWWWWWPPPPWWWWWWWW
WWWWPPPPPPPPPWWWWW
WWWWWWPGGPPPWWWWWW