WWWWWWWWWWWWWWWWWWWWWW
WWIIIIBIIITIIIBIIIIIWW
WWIOIIIIIIIILIIIIIOIWW
WWIIIIIIIIIIIIIIIIIIWW
WWWWWWWWWWGGWWWWWWWWWW
WWIIIIIIIILIIIIIIIIIWW
WWIIIIIIIIIIIIIIIIIIWW
WWIIIILIIIIIIIILIIUIWW
WWWWWGGWWWWWWWWGGWWWWW
WWIIIIIIIIIIIIIIIIIIWW
WWIIIIIIIIIIIIIIIIIIWW
WWIIIILIIIIIIILIIIIVWW
WWWWWWWWWWGGWWWWWWWWWW
WWLIIIIIOIIIIOIIIIILWW
WWIIIIIIIIIIIIIIIIIIWW
WWWWWGGWWWWWWWWGGWWWWW
WWILIIIIIIIIIIILILIIWW
WWIIIIIIIILIIIIIUIIIWW
WWVILIIIIIIIIIIIILIIWW
WWWWWWWWWWGGWWWWWWWWWW
