WWWWWWWWWWWWWWWWWWWW
WWPPLPPPPPPPPPLPPWW
WWPPPPPPPPPPPPPPWWWW
WWWWWWPPPPPPWWWWWWWW
WWPPPPPPLPPPPPPPPWWW
WWPPPPPPPPPPPPPPWWWW
WWWWWGPPPPPPGWWWWWWW
WWPPPPPPPPPPPPPPPWWW
WWPLPPPPPPPPPPLPPWWW
WWPPPPPPPPPPPPPPPWWW
WWWWWGPPPPPPGWWWWWWW
WWPPPPPPPPPPPPPPPWWW
WWPLPPPPPPPPPPPLWWWW
WWPPPPPPPPPPPPPPPWWW
WWWWWWWGPPGWWWWWWWWW
WWWPPPPPPPPPPPPPWWWW
WWWPLPPPTTPPPPLPWWWW
WWWPPPPPPPPPPPPPWWWW