WWWWWWWWWWWWWWWWWWWWWW
WWIIIIBIIITIIIBIIIIIWW
WWIOIIIIIIIILIIIIIOIWW
WWIIIIIIIIIIIIIIIIIIWW
WWWWWWWWWWGGWWWWWWWWWW
WWIIIIIIIIIIIIIIIIIIWW
WWIIIIIIIIIIIIIIIIIIWW
WWIIIILIIIIIIIILIIIIWW
WWWWWGGWWWWWWWWGGWWWWW
WWIIIIIIIIIIIIIIIIIIWW
WWIIIIIIIIIIIIIIIIIIWW
WWIIIILIIIIIIILIIIIIWW
WWWWWWWWWWGGWWWWWWWWWW
WWIIIIIIOIIIIOIIIIIIWW
WWIIIIIIIIIIIIIIIIIIWW
WWWWWGGWWWWWWWWGGWWWWW
WWIIIIIIIIIIIIIIIIIIWW
WWIIIIIIIILIIIIIIIIIWW
WWIIIIIIIIIIIIIIIIIIWW
WWWWWWWWWWGGWWWWWWWWWW
