WWWWWWWWWWWWWWWWWWWWWW
WWIIIIBIIITIIIBIIIIIWW
WWIOIIIIIIIILIIIIIOIWW
WWIIIIIIIIIIIIIIIIIIWW
WWWWWWWWWWGGWWWWWWWWWW
WWIIIIIIIIIIIIIIIIIIWW
WWIIIIIIIIIIIIIIIIIIWW
WWIIIILIIIIIIIILIIIIWW
WWWWWGGWWWWWWWWGGWWWWW
WWIIIIIIIIIIIIIIIIIIWW
WWIIIIIIIIIIIIIIIIIIWW
WWIIIILIIIIIIILIIIIVWW
WWWWWWWWWWGGWWWWWWWWWW
WWIIIIIIOIIIIOIIIIIIWW
WWIIIIIIIIIIIIIIIIIIWW
WWWWWGGWWWWWWWWGGWWWWW
WWIIIIIIIIIIIIIIIIIIWW
WWIIIIIIIILIIIIIIIIIWW
WWVIIIIIIIIIIIIIIIIIWW
WWWWWWWWWWGGWWWWWWWWWW
