FFPPHHPPPPPDPPPPHHPHFP
PFPPPPPPPDDDDDPPHPPPFP
FFDVDDPPPDDODDPPDDVDFF
FPFPPPPFPDDDDDPPPPPPPP
PFPPPPFPPPPDPPPPPPPPFP
PPPPPPFFFPPDPPPFPPPPPP
PPPPPPPPFPPDPFFPPPPPPP
PPPPPPPPPPPDPPPPFPPPPP
PPVDDDDDDDDDDDDDDDDVPP
PPPPPPPPPPPDPPPPPPPPPP
PPPPPPPPPPPDPPPPPPPPPP
PPPPPPPPPPPDPPPPPPPPPP
PPPPPPPPPPPDPPPPPPPPPP
PHPPPPPPPPPDPPPPPPPPPP
PPDVDDDDDDDDDDDDDDVDPF
HHPHPPPPPHVDPPPFPPFPFF
PHPHHPPHPPPDFPPPFPPPPF
PHPPPPPPPHPPPFPPPPPPFP
