MMMPPPPPPPPPPPPMMM
MHPVPPPPPPPPPPVPHM
HPPPPPPPPPPPPPPPHP
PPPHPPPPPPPPPHPPPP
PVPPPPPPPPPPPPPPVP
PPPPPPPPPPPPPPPPPP
PPPPPPPPPPPPPPPPPP
PPPPPPVPPPPPPPPPPP
PPPHPPPPPPPPPPHPPP
PVPPPPPPPPPPPPPPVP
PPPVPPPPVPPPPPVPPP
RRRRRRRRRRRRRRRRPP
HPPPPPPPPPPPPPPPHP
PHPPPPPPPPPPPPPMHP
PPPHPPPPPPPPPHMMHP
MMHPPPPPPPPPPHFFMM
