MMHPPPPPPPPPPHFFMM
MHPPPPPPPPPPPPFFMM
HPPPPPVPPPVPPPHPPP
PPPHPPPPPPPPPHPPPP
PPFFFPPPPPHPFFFPPP
PPFPPPPPPPPHPFPPPP
PPPPPPPPPPPPHPPPPP
PPPPPPVPPPPPPPPPMP
PPPHPPPPPPPPPPPHMP
PPPPPPPPPPPPFFHPPP
PPPPPPPPPPPPFFPPPP
RRRRRRRRRRRRRRRRPP
HPPPPPPPPPPPPPPPHP
PHPPPPPPPPPPPPPMHP
PPPHPPPPPPPPPHMMHP
MMHPPPPPPPPPPHFFMM
