MMPPPPPPPPPPPPFFMM
MPPPPPPPPPPPPPFFMM
PPPPPPVPPPVPPPPPPP
PPPPPPPPPPPPPPPPPP
PPFFFPPPPPPPFFFPPP
PPFPPPPPPPPPPFPPPP
PPPPPPPPPPPPPPPPPP
PPPPPPVPPPPPPPPPPP
PPPPPPPPPPPPPPPPPP
PPPPPPPPPPPPFFPPPP
PPPPPPPPPPPPFFPPPP
RRRRRRRRRRRRRRRRPP
PPPPPPPPPPPPPPPPPP
PPPPPPPPPPPPPPPPPP
PPPPPPPPPPPPPPPPPP
MMPPPPPPPPPPPPFFMM