PPFFPPPPPPPPPPPPPPPPPP
PFFPHHPPPPPPPPPHPFPPFP
PPPHPFPPPPPPPPPPHHFPPP
PPPFPHPPPPPPPPFPPHPPPP
RRRRRRRRRRXXRRRRRRRRRR
RRRRRRRRRRXXRRRRRRRRRR
PPVLIIILIWGGWIIIIIIPPP
PPFIIIIIIIIIIIIILIIPPP
PPPIIIIIIIIIIIIIIIIPPP
PPPOIILIIIIIIIILIIOPPP
PPPIIIIIIIIIILIIIIIPPP
PPPIIIIIIILIIIIIILIPPP
PPPIIIIIIIIIIIIIIIIPVP
PPPIIILIIIIIIIILIIIPPP
PPPIIIIIIIIIIIIIIIIHHP
PPPOIIIIIIIIIIIIIIOPPP
PPPIIIIIWBGGBWIILIIPPP
PPPIIIIIWITIIWIIILIPPP
PPPIIIIIWIIIIWIIIIIPPP
PPPPPPPPWWWWWWPPPPPPPP
