PPFFPPPPPPPPPPPPPPPPPP
PFFPHHPPPPPPPPPHPFPPFP
PPPHPPPPPPPPPPPPHHFPPP
PPPPPHPPPPPPPPPPPHPPPP
RRRRRRRRRRXXRRRRRRRRRR
RRRRRRRRRRXXRRRRRRRRRR
PPPIIIIIIWGGWIIIIIIPPP
PPPIIIIIIIIIIIIIIIIPPP
PPPIIIIIIIIIIIIIIIIPPP
PPPOIILIIIIIIIILIIOPPP
PPPIIIIIIIIIIIIIIIIPPP
PPPIIIIIIIIIIIIIIIIPPP
PPPIIIIIIIIIIIIIIIIPPP
PPPIIILIIIIIIIILIIIPPP
PPPIIIIIIIIIIIIIIIIPPP
PPPOIIIIIIIIIIIIIIOPPP
PPPIIIIIWBGGBWIIIIIPPP
PPPIIIIIWITIIWIIIIIPPP
PPPIIIIIWIIIIWIIIIIPPP
PPPPPPPPWWWWWWPPPPPPPP
