PPPPPPPPPPPPPPPPPPPP
PPPPFFPPPPPPFFPPPPPP
PPPPFFPPPPPPFFPPPPPP
PPPPPPPPPPPPPPPPPPPP
PPPPPPPPVPPPPPPPPPPP
PPPPPPPPPPPPPPPPPPPP
PPRRRRRRRRRRRRRRRRPP
PPRRRRRRRRRRRRRRRRPP
PPPPPPPPGGPPPPPPPPPP
PPPPPPWWWWWWPPPPPPPP
PPPPWWWLPPWWWWPPPPPP
PPPPWPPPPPPPPWPPPPPP
PPPPWPLPPPPLPWPPPPPP
PPPPWPPPPPPPPWPPPPPP
PPPPWWPPPPPPWWPPPPPP
PPPPPWWLTTLWWPPPPPPP
PPPPPWWWWWWWWPPPPPPP
PPPPPPPPPPPPPPPPPPPP