PPPMWWWWWWWWWWWWMPPP
PPPPWIBIIITIIBIWPPPP
PPPPWIIIIIIIIIIWPPPP
PPPPWIILIIIILIIWPPPP
PPPPWIILIIIILIIWPPPP
PHPPWIIIIIIIIIIWPPFP
PHPPWWWWWGGWWWWWPFFP
PPHPRRRRRXXRRRRRPPFF
PPPPPPPPPPPPPPPPPPFP
PHPPPPPPPPVPPPPPPPPP
PFFPFPPPPPPPPPPPPPPP
PPFPFPFPPPPPHHHPPPPP
PPPOFPFPFPPPHHPPFPPP
PPPPPPPFPPPPHPPPOPPP
PPPPPFPFPFPVHPHFFPFP
PPPPPPPFPPPPHPPPPPPP
