PPPMWWWWWWWWWWWWMPPP
PPPPWIBIIITIIBIWPPPP
PPPPWIIIIIIIIIIWPPPP
PPPPWIILIIIILIIWPFPP
PPPPWIILIIIILIIWFFPP
PHFPWIIIIIIIIIIWHFFP
PHFPWWWWWGGWWWWWPFFP
PPHPRRRRRXXRRRRRPPFF
PPPPPPPPFFFFPPPPPPFP
PHPPPPHFPPVPPPPPPPPP
PFFPFPPHHPPPPPPPPPPP
PPFPFPFPFFPPHHHPPPPP
PPPOFPFPFPPPHHPPFPPP
PPPPPFFFPPPPHHFPOPPP
PPPPPFFFHFPVHPHFFPFP
PPPPPPPFPPPPHPPPPPPP
