MMWWWWWWWWWWWWMM
MWIIILIIIILIIIIM
MWILIIIIIIIIILIM
MWIIRRRIIIIIIIIM
MWIIRRRIIIIIIIIM
MWIIIRRIIIIIIIIM
PPPGGGPPPPPPFFPP
FPPPPPPPPPPPFFPP
FFPPPPPPFFPPPPPP
PFFPPPPPFFPPPPPP
PHHPPPPPPPPPHHPP
PFOPPPPPPPPPPOFP
PPPPPPPPPPPPFFFP
PPPPPPPPPPPPPFFP
