MMPPPPPPPPPPMMPP
MPPPPPPPPPPPMMPF
PPPPPPPPPPPPPPPP
PPPPRRRPPPPPPPPP
PPPPRRRPPPPPPPPP
PPPPRRPPPPPPFFPP
PPPGGGPPPPPPPFPP
PPPPPPPPPPPPPPPP
PPPPPPPPFFPPPPPP
PPPPPPPPFFPPPPPP
PPPPPPPPPPPPPPPP
PPFPPPPPPPPPPFPP
PPFFPPPPPPPPPFPP
PPPPPPPPPPPPPPPP