CCPFFFFPPPPPPPPPPFFFFPCC
CFPPPFFPPPUUUPPPPFFFFPPC
FPPPFPFPPPUPUPPPPPPFPPFP
PFFFPFPPPPPUPPPPPPFFFPFP
FPPPFPFPDDDDPPPPPPSSFFFP
FFFPFPFFFPFDPFFFFPFPPPPF
PFPDPPPPPPPDPPPPPFFFPPPP
FFPDFFFPFPPDPPPPPPPPPPFP
FPPDDDDDDDDDVPPPFPPFFFFP
FFFDPFFFFPPPPPPPFPFPPFPF
FPFDFFSFFPPPPPPPPPPFPPFF
PPFFFPSFFPFFFPFPPPFFPPFF
FFFFPPPPFPPFPPPFFPPSSPFF
PPPPPPPFPPFPPPFFFPSSSFFF
PPPPPPPFPPPFFFFPFPFFSPPF
PPPPPPPFFPFPFPFFFPPSPFPF
PPPPPPPFFPPFFFFPPFPFFFFF
CPPPPPPPFPFPPPFFPFFPFPFC
