FFPFFFPPPFFFPFFFPPFF
FPFFPFFPPFPFPFFPPPFP
PPPFFPPPPPPPPFFPPPPP
FFPPPPVPPPPPPPPPPFFF
FPPPPPPPPPPPPPPPPPFP
PPPPFFPPPFFFPPPFFPPP
FFPPFFPPPFVFPPPFFPFF
PPPPPPPPPPPPPPPPPPPP
PPFFPPPPPPPPPPPPFFPP
PFFFPPPFFFPPPFFFPFFP
PPPPPPPPFPPPPPPPPPPP
FFPPPPPPPPPPPFFPPFFF
FPPPFFPPPPPPPFPPPFPP
PPPPFFPPPPVPPPPPPPPF
PPPPPPPPPPPPPPPPPPPF
FFPFFFPPPFFFPPFFFPFF