CCPFFFFPPPPPPPPPPFFFFPCC
CFPPPFFPPPUUUPPPPFFFFPPC
FPPPFPFPPPUPUPPPPPFFPPFP
PFFFPFPPPPPUPPPPPPFFFHFP
FPPPFPFPDDDDPPFPPPSSFFFP
FFFPFPFFFPFDPFFFFPFHPPPF
PFPDPPPPPPPDPPPFPFFFPPPP
FFPDFFFPFPPDPPPPPPPPPPFP
FHFDDDDDDDDDVPPHFPHFFFFP
FFFDPFFFFPPPPPPHFPFPPFPF
FPFDFFSFFPPPPPPPPPPFPPFF
PPFFFPSFFPFFFPFPPPFFPPFF
FFFFPPPPFPPFPPPFFPPSSPFF
PPPPPPPFFPFPPPFFFPSSSFFF
PPPPPPPFHFPFFFFPFHFFSFFF
PPPPPPPFFHFPFPFFFFPSPFPF
PPPPPPPFFPPFFFFPFFPFFFFF
CPPPPPPPFPFPPPFFHFFPFPFC
