WWWWWWWWGWWWWWWW
WIIIIIBIIIBIIIIW
WIIIIIIIIIIIIIIW
WIIIIIIIIIIIIIIW
WWWWWWWWWWWZIWWW
WIIIIIIIIIIIIIIW
WIIIIIILLIIIIIIW
WWZLWWWWWWWWWWWW
WIIIIIILIIIIIIIW
WIIIIIIILIIIIIIW
WIIILIIIIIILIIIW
WWWWWWWZLWWWWWWW
WIIIIIBIIBVIIIIW
WIIIIILIIIIIIIIW
WIIIILBIIBLIIIIW
WWWWWWWWWWWZLWWW
WIIIIIIIIIIIIIIW
WIIIILILLIIIIIIW
WIIIIIIIIILIIIIW
WWZIWWWWWWWWWWWW
WIIIIIIIIIIIIIIW
WIVIIIIIIIIIILIW
WIILIIIIIIIIIIIW
WWWWWWWWGWWWWWWW
