WWWWWWWWGWWWWWWW
WIIIIIBIIIBIIIIW
WIIIIIIIIIIIIIIW
WIIIIIIIIIIIIIIW
WWWWWWWWWWWZIWWW
WIIIIIIIIIIIIIIW
WIIIIIILLIIIIIIW
WWZIWWWWWWWWWWWW
WIIIIIIIIIIIIIIW
WIIIIIIIIIIIIIIW
WIIILIIIIIILIIIW
WWWWWWWZIWWWWWWW
WIIIIIBIIBVIIIIW
WIIIIIIIIIIIIIIW
WIIIIIBIIBIIIIIW
WWWWWWWWWWWZIWWW
WIIIIIIIIIIIIIIW
WIIIIIILLIIIIIIW
WIIIIIIIIIIIIIIW
WWZIWWWWWWWWWWWW
WIIIIIIIIIIIIIIW
WIVIIIIIIIIIIIIW
WIIIIIIIIIIIIIIW
WWWWWWWWGWWWWWWW
