WWWWWWGWWWWWWW
WLPPPPPPPPPLWW
WPWWWPPWWWPPWW
WPPPPPPPPPPPWW
WWPPWWWWPPWWWW
WLPPPPPPPPPLWW
WPWWWPPWWWPPWW
WPPPPPPPPPPPWW
WWPPWWWWPPWWWW
WLPPPPPPPPPLWW
WPWWWPPWWWPPWW
WPPPPPPPPPPPWW
WWPPWWWWPPWWWW
WLPPPPPPPPPLWW
WPPPPPPPPPPPWW
WPWWWPPWWWPPWW
WPPPPPPPPPPPWW
WWWWWWGWWWWWWW