WWWWWWWWWWWWWWWWWW
WWWWPPPPGPPPPPWWWW
WWWPPPPPPPPPPPWWWW
PPPPPPPPPPPPPPPPPP
PPPPPPPPPPPPPPPPPP
PPPPWWPPPPPWWPPPPP
PPPPWWPPPPPWWPPPPP
PPPPPPPPPPPPPPPPPP
PPPPPPPPPPPPPPPPPP
PPPPPPVPPPPVPPPPPP
PPPPPPPPPPPPPPPPPP
RRRRRRRRRRRRRRRRPP
RRRRRRRRRRRRRRRRRR
PPPPPPPPPPPPPPPPPP
PPPPPPPPPPPPPPPPPP
PPPPPPPPPPPPPPPPPP