EEEEXEEEEEEEEEXEEEXEEE
EEEEXEEEEEEEEEXEEEXEEE
PDDDDDDDODDDDDDDDDDDDP
PIIIIIIIIIDIIIIIIIIIIP
PIWWIIIIIIDIIWWIIWWIIP
PIWWIIIIIIDIIWWIIWWIIP
PIIIIIIIIIDIUIIIIIIIIP
PIIIWWIIIIDIIWWIIIWWIP
PIIIWWIIIIDIIWWIIIWWIP
PIIIIIUIIIDIIIIIIIIIIP
PIWWIIIVIIDIIIIIWWIIIP
PIWWIIIIIIDIIIIIWWIIIP
PDDDDDDDDDDDDDDDDDDDDP
PPPPPPPUPPDPPPPPPPWWPP
PPPPPPPPPPDPPPPPPPWWPP
PPPPPPPPPPDPPPPPPPPPPF
PFPFFPPPPPDPPPPPPPPVFP
PFFPPPPPPPPPPPPPPPPPFF
