EEEEXEEEEEEEEEXEEEXEEE
EEEEXEEEEEEEEEXEEEXEEE
PDDDDDDDODDDDDDDDDDDDP
PILIIIIIIIDIIIIIIIIUIP
PIWWIIIIIIDIIWWIIWWIIP
PIWWIIIIIIDIIWWIIWWIIP
PIILIIIIIIDIUIIIIILIIP
PIIIWWIIIIDIIWWIIIWWIP
PIIIWWIIIIDIIWWIIIWWIP
PIIIIIUIIIDIIIIIIIIIIP
PIWWIILVIIDIIIIIWWIIIP
PIWWULIILIDIIILIWWIIIP
PDDDDDDDDDDDDDDDDDDDDP
PPPPPPPUPPDPFPPPPPWWPP
PPPPPPPPPPDPHFPPPPWWPP
PPPPPPPPPPDPPPPPPPPHFF
PFPFFPPPPPDPPPPPPPPVFP
PFFPPPPPPPPPPPPPPPPPFF
