WWWWWWWWWWWWWWWWWWWWWWWW
WWIIIIIIBIITTIIBIIIIIIWW
WWIOIIIIIIZIIZIIIIIIOIWW
WWIIIIIIIIIDDIIIIIIIIIWW
WWIILIILIIIDDIIILIILIIWW
WWIIIIIIIIIDDIIIIIIIIIWW
WWIIIIVLIIIDDIIILIIIIIWW
WWIIIIIIIIIDDIIIIIIIIIWW
WWIILIILIIIDDIIILIILIIWW
WWIOIIIIIIIDDIIIIIIIOIWW
WWIIIIILIIIDDIIILIIIIIWW
WWIIIIIIIIIDDIIIIIIIIIWW
WWIILIILIIIDDIIILIILIIWW
WWIIIIIIIIIDDIIIIIIIIIWW
WWIIIIILIIIDDIIILIIIIIWW
WWIIIIIIIIIDDIIIIIIIIIWW
WWVILIILIIIDDIIILIILIIWW
WWIIIIIIIIIDDIIIIIIIIIWW
WWIIIIIIIIIDDIIIIIIIIIWW
WWWWWWWWWWWGGWWWWWWWWWWW
