WWWWWWWWWWWWWWWWWWWWWWWW
WWIIIIIIBIITTIIBIIIIIIWW
WWIOIIIIIIZIIZIIIIIIOIWW
WWIIIIIIIIIDDIIIIIIIIUWW
WWLILIILIIIDDIIILIILIIWW
WWIIIIIIIIIDDLIIIIIIIIWW
WWIIIIVLIIIDDILILIIIIIWW
WWIIIIIIIIIDDIIIIIIIIIWW
WWIILIILIIIDDIIILIILIIWW
WWIOIIIIIIIDDIIIIIIIOIWW
WWLIIIILIIIDDIIILIIIILWW
WWIIIIIIIIIDDIIIIIIIIIWW
WWIILIILIIIDDIIILIILIIWW
WWIIIIIIILIDDILIIIIIIIWW
WWUIIIILIIIDDIIILIIIIIWW
WWIIIIIIIIIDDIIIIIIIUIWW
WWVILIILIIIDDIIILIILIIWW
WWIIIIIIIIIDDIIIIIIIIIWW
WWIIIIIIIIIDDIIIILIIIIWW
WWWWWWWWWWWGGWWWWWWWWWWW
