WWWWWWWWWWGWWWWWWWWWWW
WWWPPPPPPPPPPPPPPPWWW
WWPPPPPPPPPPPPPPPPWWW
WWPPWWWPPPPPWWWPPPWWW
PPPPPPPPPPPPPPPPPPPPPP
PPPPPPPPPPPPPPPPPPPPPP
PPPPPPPPPPPPPPPPPPPPPP
PPPPFFFFPPPPFFFFPPPPPP
PPPPFFFFPPPPFFFFPPPPPP
PPPPPPPPPPPPPPPPPPPPPP
PPPPPPPPPPPPPPPPPPPPPP
PPPPPPPPPPPPPPPPPPPPPP
PPPFFFPPPPPPPFFFPPPPPP
PPPPPPPPPPPPPPPPPPPPPP
PPPPPPPPPPPPPPPPPPPPPP
PPPPPPPPPPPPPPPPPPPPPP
PPPPPPPPPPPPPPPPPPPPPP
PPPPPPPPPPPPPPPPPPPPPP