PPPPPPFFFFFPRRRRRPPPPPPP
PPPPPPFFFFFPRRRRRPPPPPPP
PPPPWWWWWWWWWWWWWWWWPPPP
PPPWIIIIIIWWIIIIIIIWPPPP
PPPWIIBIIIWWIIIIIIIWPPPP
PPPWIIIIIIWWIIIIIIIWPPPP
PPPWIIIIIIIIIIIIIIIWPPPP
PPPWIIWWWWWWWWIIIIIWPPPP
PPPWIIWIIIIIIWIIIIIWPPPP
PPPWIIWIIIIIIWIIIIBWPPPP
PPPWIIWIIIIIIWIIIIIWPPPP
PPPWIIWIIIIIIGIIIIITWPPP
PPPWIIWWWWWWWWWWWWWWPPPP
PPPPWIIIIIIIIIIIIIIWPPPP
PPPPWWWWWWWWWWWWWWWWPPPP
PPPPPPPPPPPPPPPPPPPPPPPP
