WWWWWWWWWWWWWWWWWWWW
WIIIBIIIIIIIIIIBIIIW
WIILIILIILIILIILIIIW
WIIIIIIIIILIIIIIIIIW
WIIIWWWWWWWWWWWWIIIW
WIIIIIIIIIIIIUIIIIIW
WILIIIILIIIIIIIIIIIW
WIILIILIILIILIILIIIW
WIIIIIILIIIIIIIIILIW
WILIIIIILIIIIIIIIIIW
WIILIILIILIILIILIIIW
WIIIIUIIIIIIIILIIIIW
WWWWWWWWWWTWWWWWWWWW
