WWWWWWWWWWWWWWWWWW
WIIIIIIIIIIIIIIIIW
WILIIIIIIIIIIIILIW
WIIWWIIIIIIIIIWWIW
WIIOIIIIIIIIIIIIIW
WLIIIIIIIIIIIIIILW
WIIWWIIIIIIIIIWWIW
WIIIIIIIIIIIIIIIIW
WILIIIIIIIIIIIILIW
WIIIIIIIIIIIIIIIIW
WIIIIIIIIIIIIIIITW
WWWWWWWWWWWWWWWWWW