WWWWWWWWWWWWWWWWWWWW
WIIIBIIIIIIIIIIBIIIW
WIILIILIILIILIILIIIW
WIIIIIIIIIIIIIIIIIIW
WIIIWWWWWWWWWWWWIIIW
WIIIIIIIIIIIIIIIIIIW
WIIIIIIIIIIIIIIIIIIW
WIILIILIILIILIILIIIW
WIIIIIIIIIIIIIIIIIIW
WIIIIIIIIIIIIIIIIIIW
WIILIILIILIILIILIIIW
WIIIIIIIIIIIIIIIIIIW
WWWWWWWWWWTWWWWWWWWW
