WWWWWWWWWWWWWWWWW.
IIIIIIIIIIIIIIIIW.
WILIILIILIILIILIW.
WIIIIIIIIIIIIIIIW.
WIIWWWWWWWWWWWIIW.
WIIIIIIIIIIIIIIIW.
WILIILIILIILIILIW.
WIIIIIIIIIIIIIIIW.
WILIILIILIILIILIW.
WIIIIIIIIIIIIIIIW.
WWWWWWWWITWWWWWWW.