MMPPPPPPPPMMPPMPPPPPPPMM
MPPPPPPPPPPPPFHPPPHPHHPM
PPPPPPFFPFFHUFFPPHPOPPPM
PPPFFFUPPPPPHFPPPPHPHHPP
PPPPFFPHPFPPPFPHPPFPHPPP
PPFPPPPPFFPPPPPPPFFFPPHP
PFFPPPPFPFPPPHPPFFFFVFFP
PPHPPPPPFFFPPFFPHFFFFFPP
PPPRRXXPPPPPPFFFXXRRFFPP
RRRRRXXRRRHPPFRRXXRRRRRR
RRRHFPPRRRRRRRRRPPPFRRRR
PHHFFHPPPFRRRRPFFFPFHPPP
PPHPFFPPPVFFHFFFPFPFPHPP
PPPPFFPPFFFFFPPFHPPPHFPP
PPPFPFFHFFFFPPPFPPPPPFPP
PPPPPPPHPPPPPPPPFPPPPPPP
MPPPOPPHFPPPPPPPHFPPPPPM
MPPPPPPPPPPPPPPPPPPPPPMM
