FFFFFFFFFFFFFFFF
FFPPR++++++++RPP
FFPPPRRRRRRRPPPF
FFPPPPPPPPPPPPPF
PFPFFFFFFPFFPPPP
PFPFPPPPPFPPVPPP
PFPFPPPPPFPPPPPP
PFFFFFFPPFPPPPPP
PPPPPPPPPFPPPPPP
PPPRRRRRRRPPPPPP
PPPR++++++++RPPP
PPPRRRRRRRPPPPPP
PPPPPPPPPPPPPPPP
PPPPPPPPPPPPPPPP