MMPPPPPPPPMMPPMPPPPPPPMM
MPPPPPPPPPPPPPPPPPHPHHPM
PPPPPPPPPPPPUPPPPHPOPPPM
PPPFFFUPPPPPHPPPPPHPHHPP
PPPPFFPHPFPPPPPHPPFPHPPP
PPPPPPPPFFPPPPPPPFFFPPHP
PPPPPPPFPFPPPHPPFFFFVPPP
PPPPPPPPFFFPPFFPPFFFPPPP
PPPRRXXPPPPPPFPPXXRRPPPP
RRRRRXXRRRPPPFRRXXRRRRRR
RRRHPPPRRRRRRRRRPPPPRRRR
PHHPPPPPPFRRRRPFPPPPPPPP
PPHPFFPPPVFFPFFFPFPPPPPP
PPPPFFPPFFFFFPPFHPPPPPPP
PPPFPFFPFFFFPPPFPPPPPPPP
PPPPPPPPPPPPPPPPPPPPPPPP
MPPPOPPPPPPPPPPPPPPPPPPM
MPPPPPPPPPPPPPPPPPPPPPMM
