FFFMMHPPPPPHFFFF
FFPMMPPPPHFPPHMFF
FPPPPOFFPFPPHPPF
HPPPPPPPFFPPMHPP
PFFFFFFFPPPPMHPP
PFPFPPPHPFPPPPPP
PFPFPPPPPFPVPPPP
PFFFFFFPPFHPPPPP
PPPHPPPPRRRRPPMP
PPPPFPRRPPPPHPPP
PHPPPRRHPPPPPMPP
PPOPRRPPHPFFHPPP
PPPRRPPPPFFFFFFP
PPRRPPPPPPFFFFFP
