FFFMMPPPPPPPFFFF
FFPPPPPPPFPPPPFF
FPPPPOFFPFPPPPPF
PPPPPPPPFFPPPPPP
PFFFFFFFPPPPMPPP
PFPFPPPPPFPPPPPP
PFPFPPPPPFPVPPPP
PFFFFFFPPFPPPPPP
PPPPPPPPRRRRPPPP
PPPPFPRRPPPPPPPP
PPPPPRRPPPPPPFPP
PPOPRRPPPPFFPPPP
PPPRRPPPPFFFFFFP
PPRRPPPPPPFFFFFP
